MIDIRouter_Lib	KEYWORD1
inputPortFilter	KEYWORD2
inputAt	KEYWORD2
outputAt	KEYWORD2
setRealtime	KEYWORD2
setRealtime	KEYWORD2
setNotes	KEYWORD2
setControllers	KEYWORD2
setSysex	KEYWORD2
setMidiclock	KEYWORD2
realtimeFiltered	KEYWORD2
notesFiltered	KEYWORD2
controllersFiltered	KEYWORD2
sysexFiltered	KEYWORD2
midiclockFiltered	KEYWORD2
active	KEYWORD2
MRInputPort	KEYWORD1
MROutputPort	KEYWORD1
MidiFilterLocation	KEYWORD1
MidiFilter	KEYWORD1
